....................
................WW..
............O.......
...O..O.............
...O................
.O.O................
...OB...............
...OFFFFFFFF...F....
....................
....FFFFFFFF........
....................
...............F....
....................
P.................S.
FFFFFFFFFFFFFFFFFFFF