....................
....................
..............OOWWW.
..............O.....
..............OO....
....................
............OO......
....................
..........OO........
....................
.........B..........
.........FFFFFF.OOO.
...FF...........O...
PFF.............O...
FFFFFFFFFFFFF.OOFFF